R 920 540
NO ./textures/banner.xpm
SO ./textures/blue.xpm
WE ./textures/brick.xpm
EA ./textures/grey.xpm
S ./textures/chalice.xpm
F 255, 255, 0
C 0, 0,0

1111111111111111111111111111111
1000000000000000000000000000001
1000000000000000000000000000001
1000000000000000000000000000001
1000000000000000000000000000001
1000000000000000000000000000001
1000000000000000000000000000001
10000000000000000000000E0000001
1000000000000000000000000000001
1000000000000000000000000000001
1000000000000000000000000000001
1000000000000000000000000000001
1000000000000000000000000000001
1000000000000000000000000000001
1000000000000000000000000000001
1000000000000000000000000000001
1000000000000000000000000000001
1111111111111111111111111111111
