R 920 540
NO ./textures/banner.xpm
SO ./textures/blue.xpm
WE ./textures/brick.xpm
EA ./textures/grey.xpm
S ./textures/chalice.xpm
F 255, 255, 0
C 0, 0,0

1111111111111111111111111111111
1222222222222222222222222222221
1222222222222222222222222222221
1222222222222222222222222222221
1222222222222222222222222222221
1222222222222222222222222222221
1222222222222222222222222222221
12222222222222222222222E2222221
1222222222222222222222222222221
1222222222222222222222222222221
1222222222222222222222222222221
1222222222222222222222222222221
1222222222222222222222222222221
1222222222222222222222222222221
1222222222222222222222222222221
1222222222222222222222222222221
1222222222222222222222222222221
1111111111111111111111111111111
