R 920 540
NO ./textures/banner.xpm
SO ./textures/blue.xpm
WE ./textures/brick.xpm
EA ./textures/grey.xpm
S ./textures/barrel.xpm
F 255, 255, 0
C 0, 0,0

111111
100001
100101
101001
1000N1
111111
